0000000000000
0000000000000
0000000000000
0000000000000
0000000000000
1000000000001
1110000000111
1111100111111

